original	foreign
pseudo-scorpion	Pseudo-Skorpion
baracudda	baracudda
blackamoor	Mohr
faun	Faun
crucifix	Kruzifix
exoplanet	Exoplanet
barracuda	Barrakuda
limousine	Limousine
cockatoo	Kakadu
tombstone	Grabstein
fraser	Fraser
giraffe	Giraffe
sunset	Sonnenuntergang
padlock	Vorhängeschloss
woman	Frau
stork	Storch
gravesite	Grabstätte
saint	Heilige
eagle	Adler
donkey	Esel
deity	Gottheit
clown	Clown
elephant	Elefant
cow	Kuh
tiger	Tiger
mermaid	Meerjungfrau
stewardess	Stewardess
kitten	Kätzchen
unicorn	Einhorn
horseman	Reiter
waterfall	Wasserfall
snowman	Schneemann
lighthouse	Leuchtturm
ethidium	Ethidium
wolf	Wolf
lion	Löwe
soldier	Soldat
snake	Schlange
swastika	Hakenkreuz
object	Objekt
monkey	Affe
knight	Ritter
cat	Katze
man	Mann
rattlesnake	Klapperschlange
damsel	Maid
butterfly	Schmetterling
serpent	Schlange
dragon	Drachen
skull	Schädel
fetus	Fötus
billboard	Reklametafel
dolphin	Delphin
gorilla	Gorilla
morphism	Morphismus
fingerprint	Fingerabdruck
firework	Feuerwerk
angel	Engel
bird	Vogel
meteor	Meteor
bunny	Hase
homomorphism	Homomorphismus
penguin	Pinguin
owl	Eule
teddy	Teddy
flower	Blume
oscilloscope	Oszilloskop
ox	Ochse
girl	Mädchen
fiend	Teufel
planet	Planeten
spider	Spinne
guy	Kerl
painting	Malerei
duck	Ente
cobra	Kobra
lady	Dame
skeleton	Skelett
pyramid	Pyramide
statue	Statue
scene	Szene
peacock	Pfau
witch	Hexe
commonwealth	Gemeinwesen
dinosaur	Dinosaurier
indent	Gedankenstrich
pumpkin	Kürbis
windmill	Windmühle
cowboy	Cowboy
airplane	Flugzeug
rainbow	Regenbogen
sportsman	Sportler
apple	Apfel
plough	Pflug
kangaroo	Känguru
dog	Hund
parrot	Papagei
turtle	Schildkröte
moose	Elch
baby	Baby
boy	Junge
vase	Vase
rabbit	Kaninchen
star	Stern
person	Person
galaxy	Galaxie
swan	Schwan
stag	Hirsch
cube	Würfel
orb	Gestirn
pig	Schwein
comet	Komet
tree	Baum
alligator	Alligator
demon	Dämon
cross-section	Querschnitt
scientist	Wissenschaftler
castle	Burg
bull	Stier
nun	Nonne
barn	Scheune
child	Kind
phoenix	Phoenix
distraction	Ablenkung
ant	Ameise
candle	Kerze
sculpture	Skulptur
circle	Kreis
brand-new	brandneue
sunflower	Sonnenblume
graveyard	Friedhof
hamburger	Hamburger
iceberg	Eisberg
mosque	Moschee
sphere	Kugel
zebra	Zebra
triangle	Dreieck
turkey	Truthahn
machine	Maschine
keyboard	Tastatur
corpse	Leiche
globe	Globus
astronaut	Astronaut
shepherd	Schäfer
kid	Kind
puppy	Hund
koala	Koala
fox	Fuchs
patient	Patient
shark	Hai
sailor	Seemann
infant	Kleinkind
mural	Wandgemälde
fairy	Fee
chick	Küken
pipe	Rohr
kite	Drachen
celebrity	Berühmtheit
slowdown	Verlangsamung
mountain	Berg
landscape	Landschaft
volcano	Vulkan
house	Haus
ghost	Gespenst
animal	Tier
horse	Pferd
freeway	Autobahn
clock	Uhr
goddess	Göttin
cake	Kuchen
face	Gesicht
gun	Pistole
warrior	Krieger
politician	Politiker
creature	Kreatur
cavern	Höhle
tornado	Tornado
diver	Taucher
mushroom	Pilz
atom	Atom
robbery	Raub
banana	Banane
puppet	Marionette
economist	Ökonom
priest	Priester
photograph	Foto
ob	OB
fisherman	Fischer
goo	Schmiere
plane	Flugzeug
beetle	Käfer
cop	Polizist
goat	Ziege
librarian	Bibliothekar
dude	dude
lake	See
prisoner	Häftling
whale	Wal
car	Auto
ship	Schiff
truck	LKW
slice	Scheibe
toddler	Kleinkind
couple	Paar
athlete	Sportler
fish	Fisch
bat	Fledermaus
character	Charakter
bicycle	Fahrrad
eye	Auge
cucumber	Gurke
bridge	Brücke
sheep	Schafe
leaf	Blatt
fountain	Brunnen
wizard	Assistenten
lock	Sperre
cigarette	Zigarette
lamb	Lamm
continent	Kontinent
folder	Ordner
mother	Mutter
arrow	Pfeil
monster	Monster
cutie	cutie
society	Gesellschaft
poster	Plakat
building	Gebäude
bomb	Bombe
item	Artikel
plump	rundlich
necklace	Halskette
rectangle	Rechteck
rebel	Rebell
picture	Bild
sample	Probe
cheerleader	Cheerleader
mouse	Maus
train	Zug
river	Fluss
ruler	Herrscher
motorcycle	Motorrad
molecule	Molekül
map	Karte
sign	Anmelden
city	Stadt
boat	Boot
snow	Schnee
document	Dokument
hero	Held
temple	Tempel
church	Kirche
dancer	Tänzerin
backdrop	Hintergrund
pitcher	Krug
nation	Nation
disk	Festplatte
hand	Hand
spiral	Spirale
cloud	Wolke
chair	Stuhl
quilt	Steppdecke
crown	Krone
beach	Strand
nail	Nagel
vertex	Scheitel
chicken	Huhn
flag	Flagge
egg	Ei
ladder	Leiter
lamp	Lampe
organisation	Organisation
diffraction	Beugung
street	Straße
scream	Schrei
knife	Messer
tomato	Tomate
bride	Braut
passport	Reisepass
friend	Freund
robot	Roboter
company	Unternehmen
landmark	Wahrzeichen
neighborhood	Nachbarschaft
plant	Pflanze
gentleman	Gentleman
product	Produkt
teenager	Teenager
organ	Orgel
king	König
signature	Unterschrift
mask	Maske
particle	Teilchen
seal	Dichtung
lemon	Zitrone
lip	Lippe
bike	Fahrrad
actor	Schauspieler
helicopter	Hubschrauber
enemy	Feind
ball	Kugel
country	Land
hole	Loch
toy	Spielzeug
totem	Totem
forest	Wald
fist	Faust
par	Par
envelope	Umschlag
un	un
cottage	Ferienhaus
room	Zimmer
hurricane	Hurrikan
stamp	Stempel
bullet	bullet
brain	Gehirn
figure	Abbildung
window	Fenster
disc	Disc
pole	Pol
toilet	Toilette
world	Welt
camera	Kamera
target	Ziel
situation	Situation
heart	Herz
smiley	Smiley
organization	Organisation
photographer	Fotograf
bus	Bus
model	Modell
logo	Logo
family	Familie
pond	Teich
destination	Ziel
letter	Schreiben
brand	Marke
region	Region
defect	Defekt
hat	Hut
sword	Schwert
sin	sin
bottle	Flasche
bell	Glocke
element	Element
quantum	Quanten-
page	Seite
flame	Flamme
partition	Partition
point	Punkt
cell	Zelle
CD	CD
murder	Mord
orange	orange
nucleus	Kern
wheel	Rad
photo	Foto
event	Veranstaltung
tank	Tank
candidate	Kandidat
shoe	Schuh
storm	Sturm
haven	Oase
clip	Clip
leg	Bein
underwear	Unterwäsche
table	Tabelle
moment	Moment
leader	Führer
sun	Sonne
journey	Reise
tongue	Zunge
outfit	Outfit
non	nicht
wall	Wand
economy	Wirtschaft
farm	Bauernhof
universe	Universum
sub	sub
pantyhose	Strumpfhose
artwork	Kunstwerk
artist	Künstler
place	Ort
town	Stadt
crowd	Menschenmenge
profession	Beruf
area	Bereich
surface	Oberfläche
entity	Einheit
garden	Garten
writer	Schriftsteller
battery	Batterie
secretary	Sekretärin
soul	Seele
wound	Wunde
crack	Riss
book	Buch
institution	Institution
dream	Traum
father	Vater
computer	Computer
hip	Hüfte
finger	Finger
interval	Intervall
mouth	Mund
section	Abschnitt
crystal	Kristall
box	Box
phenomenon	Phänomen
com	com
aircraft	Flugzeuge
printer	Drucker
door	Tür
pre	vor
edge	Kante
rock	Rock
camp	Lager
guitar	Gitarre
word	Wort
corporation	Gesellschaft
career	Karriere
cream	Sahne
community	Gemeinde
sailing	Segeln
lifetime	Lebensdauer
body	Körper
image	Bild
piano	Klavier
curve	Kurve
epidemic	Epidemie
era	Ära
con	con
sequence	Sequenz
slide	Rutsche
classroom	Klassenzimmer
culture	Kultur
plate	Platte
head	Kopf
vehicle	Fahrzeug
grid	Gitter
lawyer	Rechtsanwalt
industry	Industrie
film	Film
self	Selbst
student	Student
ear	Ohr
pleasure	Vergnügen
cup	Tasse
mirror	Spiegel
gel	Gel
village	Dorf
device	Gerät
band	Band
university	Universität
fire	Feuer
pattern	Muster
television	Fernsehen
thing	Sache
button	Button
ad	Anzeige
segment	Segment
sport	Sport
tumor	Tumor
reality	Realität
graph	Grafik
rat	Ratte
line	Linie
restaurant	Restaurant
park	Park
bug	Bug
phone	Telefon
casino	Casino
calendar	Kalender
skin	Haut
album	Album
professor	Professor
road	Straße
football	Fußball
bikini	Bikini
path	Pfad
electron	Elektron
stream	Stream
field	Feld
incident	Zwischenfall
election	Wahl
hair	Haar
lingerie	Unterwäsche
teacher	Lehrer
officer	Offizier
kitchen	Küche
life	Leben
TV	TV
school	Schule
island	Insel
stuff	Zeug
topic	Thema
node	Knoten
transition	Übergang
middle	Mitte
bed	Bett
